96 83
71 43 1 19 98 54 22 76 90 58 65 95 63 97 78 71 9 59 43 50 66 52 10 39 92 69 78 35 93 38 2 80 61 81 21 43 6 71 49 74 72 12 14 92 63 69 23 67 21 58 33 1 26 59 26 7 66 67 90 23 52 36 38 90 58 86 59 56 98 34 87 79 87 55 65 58 22 93 17 17 74 46 30 4 39 93 92 34 32 22 55 47 47 84 44 63
65 6 7 3 43 31 31 55 10 7 10 27 82 96 43 26 89 91 39 39 9 69 24 87 94 29 35 2 17 46 4 15 79 1 100 63 1 20 73 75 56 27 62 13 55 34 79 36 85 44 60 10 97 24 51 95 83 59 55 39 35 46 32 6 71 4 10 82 4 11 90 1 16 30 66 95 93 100 76 47 46 31 57 31 42 67 60 78 53 19 44 21 56 18 84 44
87 60 53 19 31 61 89 26 34 49 97 97 37 87 12 89 94 20 98 36 14 13 27 60 44 41 15 77 79 61 19 80 92 29 15 32 30 70 24 63 59 44 44 16 81 56 43 67 12 63 6 48 10 6 93 35 96 30 77 79 99 81 59 89 55 3 84 2 91 48 92 94 31 96 76 44 72 61 19 53 73 65 4 44 9 84 63 28 89 31 85 100 8 92 89 26
23 2 10 37 36 75 56 95 57 37 36 31 51 65 36 5 19 75 32 31 57 65 95 81 45 30 26 59 61 56 15 4 68 84 34 96 77 83 93 63 89 4 55 54 8 70 18 62 59 56 13 26 50 38 91 71 78 69 80 80 17 73 85 15 35 5 63 58 68 44 49 32 11 82 73 31 21 71 24 19 16 76 29 46 21 62 67 82 34 22 53 84 31 90 10 50
99 96 41 33 100 12 74 1 29 25 84 20 88 8 82 85 25 24 6 38 26 39 61 91 22 74 9 28 92 66 82 75 98 92 28 60 12 15 64 91 21 25 11 30 58 27 35 98 33 84 100 29 3 85 45 52 5 48 9 95 26 92 45 83 90 81 33 31 5 53 4 4 49 27 87 47 77 62 4 97 40 39 61 8 61 42 52 98 76 10 67 79 11 16 70 70
77 59 75 90 6 39 7 14 18 67 82 2 55 34 61 57 32 22 21 74 86 27 6 52 39 43 63 2 33 60 35 93 21 7 74 75 28 57 96 55 40 50 86 13 72 69 99 81 93 36 79 39 26 83 33 54 34 85 16 68 96 81 8 30 61 84 94 61 24 61 1 33 28 53 92 59 16 15 43 21 77 95 52 56 53 47 9 79 71 7 9 69 68 63 78 48
99 24 28 98 97 48 72 90 77 56 50 43 81 54 83 73 98 61 100 56 8 71 75 26 83 42 79 97 77 29 17 56 86 13 37 78 62 36 96 52 89 48 65 60 6 55 40 75 40 21 4 19 3 34 97 6 71 20 58 17 66 80 61 95 40 76 48 38 64 90 43 97 69 82 3 73 37 55 70 61 37 57 81 10 40 45 56 74 25 85 84 49 34 84 61 23
42 66 55 98 88 77 51 51 70 5 4 90 17 16 16 4 63 59 82 56 79 49 64 97 20 6 77 79 93 80 35 1 26 7 27 29 13 17 96 82 89 12 71 31 96 66 51 48 13 17 50 69 39 15 15 65 34 29 52 21 40 79 37 28 2 65 100 22 70 80 54 31 88 70 62 8 32 44 69 88 54 5 92 54 46 40 14 26 76 33 96 48 93 1 93 6
69 19 73 9 5 37 82 77 87 39 100 84 71 61 35 73 29 19 96 57 14 93 78 90 48 82 3 84 15 21 21 40 26 23 77 25 53 34 88 57 40 87 64 61 5 58 31 34 58 39 30 20 31 37 11 50 11 84 2 98 63 81 73 54 38 48 74 1 27 3 62 20 65 27 9 79 45 42 86 42 21 17 18 9 60 98 91 81 67 41 98 8 39 14 33 66
51 28 83 64 28 45 89 33 59 64 56 52 73 20 22 82 33 17 77 3 23 57 43 86 50 50 56 50 13 16 11 75 85 25 81 63 2 92 51 77 2 56 4 71 38 76 93 3 44 62 44 15 57 53 12 19 30 5 13 21 54 17 79 13 60 33 24 24 83 1 5 43 1 15 54 19 98 14 56 66 76 5 78 79 23 47 68 6 58 23 56 19 13 50 36 91
62 2 38 31 85 58 30 14 35 18 85 32 62 81 35 78 95 77 43 46 15 38 99 77 95 5 45 22 38 15 61 7 10 6 92 47 64 90 41 89 26 11 66 86 25 86 3 84 78 67 97 44 40 45 85 20 82 39 37 24 19 9 36 94 19 24 37 67 93 88 62 32 77 84 51 86 75 9 27 51 7 55 55 43 75 9 86 25 4 5 86 74 90 29 49 36
25 31 31 43 82 17 5 65 50 72 73 88 30 87 79 77 2 61 92 31 85 65 8 93 84 75 63 95 7 60 79 45 76 55 68 85 2 11 94 93 53 19 3 6 25 100 36 24 50 36 37 2 25 87 81 52 74 71 21 35 23 6 62 65 83 69 82 60 56 14 77 64 95 40 43 53 74 1 9 41 61 91 41 4 78 27 5 98 38 21 86 19 96 83 3 92
16 79 85 23 61 41 1 40 88 32 76 36 31 15 63 97 7 87 85 8 95 38 92 58 3 36 57 49 68 96 8 38 93 16 97 15 79 22 78 22 13 76 25 66 26 78 11 81 100 80 86 87 19 55 23 16 28 34 60 42 82 11 38 11 32 8 76 95 37 66 90 34 96 34 95 55 46 22 16 93 78 53 60 48 4 61 83 52 18 42 93 94 90 51 13 28
52 28 33 75 80 84 77 31 97 96 53 79 92 31 98 55 85 79 25 75 19 42 37 49 26 51 32 64 80 4 16 28 37 54 81 68 39 54 54 6 85 17 68 41 92 73 33 22 75 78 69 18 45 96 64 62 89 11 4 41 49 88 81 60 28 68 26 49 92 2 13 74 15 88 44 50 7 36 95 83 69 85 34 11 39 88 78 25 18 54 67 85 13 37 56 44
89 69 98 38 24 73 62 84 13 83 41 68 66 8 76 6 17 82 73 68 71 17 12 99 96 93 63 4 5 85 100 33 82 90 18 24 41 21 69 30 10 22 41 38 5 63 56 81 58 83 11 31 78 40 60 62 30 28 68 43 61 50 88 10 5 81 64 25 59 1 59 85 17 51 72 47 56 79 50 38 100 37 61 17 58 28 35 36 54 86 85 66 54 48 60 83
5 52 65 69 50 51 14 70 40 46 67 15 55 84 77 100 58 15 47 88 20 62 39 32 83 74 80 82 94 28 5 25 34 90 67 96 27 21 47 75 53 30 81 29 93 42 97 46 47 74 19 75 24 47 37 11 77 77 83 65 58 91 41 41 31 84 100 36 46 7 72 89 99 90 30 78 54 42 21 8 54 78 8 46 16 62 65 46 22 81 74 26 34 74 38 92
61 47 41 56 65 86 43 8 75 24 13 78 27 78 92 57 23 67 46 50 82 3 97 22 33 47 67 96 93 10 40 90 42 19 59 74 24 37 55 62 80 2 10 75 62 3 67 18 92 31 17 30 56 90 63 89 75 52 81 69 54 9 72 54 33 46 91 92 77 51 76 4 75 33 58 30 50 2 78 24 39 23 73 12 11 78 69 20 57 87 20 83 93 57 15 65
99 86 42 33 69 17 94 71 45 22 82 21 3 66 79 66 15 86 6 41 5 82 85 46 5 61 55 89 86 25 35 8 28 55 38 48 16 51 33 5 94 78 94 17 12 41 43 7 99 68 80 27 89 76 39 67 44 7 90 24 32 15 7 28 21 26 21 74 85 23 74 30 57 18 88 39 7 35 1 13 22 77 76 85 78 91 10 80 25 5 5 94 2 55 88 79
55 84 74 75 72 19 27 80 18 86 8 34 15 76 11 82 21 59 92 74 80 38 8 45 76 49 92 59 75 12 38 71 94 35 42 63 76 19 85 41 86 85 90 17 22 34 12 55 54 18 81 9 24 56 67 16 65 8 62 89 74 38 3 90 45 15 52 44 37 21 40 3 82 1 34 90 61 74 18 30 53 43 67 14 61 41 38 50 7 75 79 96 59 72 24 76
45 79 67 56 96 53 94 9 87 12 9 57 89 18 17 62 92 6 31 83 53 11 73 27 39 87 49 78 88 91 92 43 60 54 47 65 98 58 78 41 15 51 84 4 67 29 14 84 55 94 86 58 61 38 67 27 86 84 90 69 12 23 77 38 10 33 73 17 62 73 31 36 30 72 59 12 61 64 29 41 30 100 4 91 4 61 53 80 36 67 14 54 51 6 26 3
75 64 9 92 73 46 2 53 85 83 5 90 59 41 10 87 17 48 34 72 95 47 47 27 80 99 62 3 19 13 43 69 78 84 19 51 40 72 47 80 44 28 54 20 49 35 22 11 81 56 69 26 3 72 5 86 57 75 50 66 84 48 27 14 6 39 29 78 96 49 93 23 97 66 12 70 35 5 100 22 2 23 92 30 14 56 3 35 38 63 36 24 76 4 1 56
36 54 49 51 5 6 62 7 40 51 89 92 51 43 65 15 49 53 59 84 8 54 50 51 8 85 91 15 25 43 15 11 71 92 87 46 67 55 88 19 18 39 60 38 3 70 5 32 71 25 9 40 50 45 68 47 48 6 55 89 51 20 54 84 40 20 100 12 28 52 73 45 6 80 19 31 55 62 56 51 80 95 1 14 92 60 73 8 96 45 92 22 75 54 51 11
46 89 7 68 34 14 65 42 66 70 73 20 75 92 65 61 56 98 96 75 85 92 90 20 46 61 22 56 34 19 92 27 22 42 88 7 13 31 26 54 64 82 65 66 10 2 87 3 42 83 19 43 69 30 42 82 43 21 22 2 98 45 2 27 44 49 85 9 81 81 67 59 77 85 36 20 100 31 20 64 17 85 24 59 55 74 94 6 3 44 71 92 97 92 96 8
15 52 4 14 39 61 26 93 59 43 48 40 21 93 12 86 52 33 7 74 15 27 35 70 80 16 69 3 10 61 99 15 38 59 53 53 23 4 31 33 62 43 93 10 2 5 93 41 4 28 19 71 49 61 1 77 95 47 90 54 46 57 46 18 37 65 29 45 97 41 53 32 95 28 58 23 3 85 70 72 88 53 67 75 5 66 68 90 22 13 68 73 57 10 43 36
19 20 32 94 99 21 53 13 17 5 80 18 12 6 90 74 28 53 90 21 62 3 25 27 28 46 67 16 46 60 27 11 57 7 50 10 27 74 56 45 56 4 97 82 16 39 15 38 34 75 30 38 100 11 32 3 78 61 45 42 15 2 39 63 51 12 74 75 15 11 75 31 79 48 30 34 8 28 18 76 94 100 2 86 20 58 86 33 77 87 80 79 61 84 44 29
21 16 64 17 72 59 80 96 87 44 87 77 55 71 87 25 42 90 37 14 38 93 91 51 94 56 45 31 71 55 6 62 71 19 84 93 58 71 50 85 82 10 81 79 43 80 35 26 83 21 87 40 79 84 59 12 58 98 13 84 40 76 95 77 12 43 13 49 95 54 60 52 100 39 81 96 28 4 98 94 28 1 87 68 36 5 35 33 54 16 50 84 31 78 65 75
47 68 82 85 14 8 96 3 23 13 77 4 96 42 80 100 78 20 24 53 50 37 26 4 69 1 75 26 56 24 63 37 1 56 48 80 46 99 20 32 89 92 22 24 67 93 4 87 12 44 54 92 24 45 83 18 7 40 22 23 64 33 68 39 91 77 1 75 44 14 6 67 22 33 81 76 19 65 30 73 70 93 45 43 17 15 41 35 67 86 64 18 93 94 34 38
11 85 77 60 31 85 85 76 52 48 6 41 72 77 75 5 53 35 59 4 57 45 23 49 57 14 27 99 80 11 57 56 36 23 38 26 92 80 28 52 89 99 59 30 23 12 73 95 82 80 12 11 74 5 36 90 72 95 19 1 65 95 16 52 19 27 59 23 32 72 64 21 24 95 53 54 35 40 96 90 17 30 44 44 74 97 21 41 100 17 86 60 32 22 34 79
66 75 2 93 92 2 22 91 48 63 6 73 20 32 10 87 77 82 31 25 51 52 96 62 46 84 83 96 47 77 49 66 33 82 70 2 14 24 99 37 16 80 33 83 75 63 28 83 9 41 69 30 69 64 93 89 41 16 98 54 44 90 17 77 8 23 64 53 18 49 84 8 71 1 75 63 46 20 31 97 1 36 63 26 79 68 15 46 33 8 6 33 57 7 70 4
93 49 5 11 66 55 40 52 30 63 86 14 69 72 15 48 11 47 60 80 70 13 49 7 41 42 3 23 94 4 86 20 61 48 88 80 97 81 99 86 70 34 45 89 73 55 4 54 29 73 43 72 44 90 68 99 5 27 99 43 34 57 33 89 8 1 44 88 93 79 86 16 82 32 77 72 60 32 63 11 37 46 29 96 35 43 23 97 15 1 95 72 45 97 47 72
78 19 18 5 46 37 83 8 74 38 75 18 64 68 7 15 24 100 14 78 92 16 11 30 4 61 77 48 48 54 50 47 18 53 80 22 66 47 12 60 47 69 98 12 26 10 43 20 9 20 28 96 74 28 2 37 41 24 25 4 45 30 56 61 74 98 17 32 51 54 93 29 22 55 90 73 64 2 94 85 96 88 87 58 100 91 33 50 37 53 88 4 60 14 84 53
2 3 49 38 79 36 40 35 84 87 36 41 58 45 21 30 32 75 27 42 51 76 63 96 49 9 80 2 39 45 73 43 11 84 56 19 5 53 76 88 96 61 19 29 45 89 14 44 55 92 62 56 17 43 16 5 54 27 100 62 1 55 99 35 76 97 26 86 97 90 36 79 53 60 83 56 75 68 66 62 96 52 35 51 20 91 26 67 44 38 64 30 59 26 98 55
49 31 74 1 56 77 33 78 55 82 4 18 99 94 59 79 80 22 50 47 44 54 50 41 14 77 40 36 2 16 81 86 16 43 73 18 45 10 26 25 1 1 96 57 9 75 85 95 43 51 93 43 99 28 76 36 61 41 100 84 46 20 3 44 1 75 68 4 89 66 9 92 33 31 88 10 83 40 44 81 62 74 100 65 48 16 63 42 35 37 48 66 9 7 61 93
12 20 69 59 9 9 86 26 56 48 51 9 76 92 44 69 21 69 85 77 47 100 15 42 42 49 55 66 48 23 22 19 2 36 75 48 74 22 58 3 21 13 66 53 55 43 31 94 72 56 98 50 8 11 81 10 16 48 55 51 89 25 80 59 13 17 92 98 19 35 17 11 12 74 33 22 47 30 7 10 47 49 69 40 16 70 55 26 80 72 72 6 81 61 43 26
10 82 80 66 22 85 12 5 19 64 10 53 51 74 32 66 84 59 49 87 49 46 46 15 8 40 81 76 20 68 60 69 35 93 5 27 91 88 86 39 85 72 62 57 21 96 56 61 39 64 51 100 74 75 74 11 31 78 45 18 14 74 48 45 91 2 95 31 63 33 7 17 31 95 92 80 6 25 98 23 35 68 81 51 60 47 3 77 65 12 37 56 64 22 2 90
31 94 75 20 91 97 39 90 71 49 37 32 48 31 49 33 76 58 58 47 96 56 31 81 24 30 26 46 97 69 9 32 39 63 34 69 1 22 22 23 31 58 47 47 81 70 34 34 26 15 73 100 92 85 61 79 92 58 71 38 55 68 73 82 32 92 98 92 35 15 36 18 24 9 66 39 79 53 32 14 63 79 22 85 72 32 63 72 72 79 40 26 56 94 45 40
20 35 78 19 59 29 17 82 8 52 96 35 7 88 76 55 64 64 73 61 93 22 78 72 83 92 1 75 31 72 98 46 73 48 41 79 93 11 94 60 76 25 62 48 98 42 60 46 91 56 34 33 28 90 17 47 32 18 43 69 39 70 80 69 10 86 15 31 71 81 23 87 5 73 60 87 2 7 54 100 6 17 88 45 41 91 23 76 92 99 39 81 61 71 53 97
3 69 9 13 58 58 96 17 68 29 30 48 83 64 1 78 15 76 41 72 84 83 30 16 51 89 62 94 65 51 28 63 1 100 43 44 92 35 84 22 61 62 26 19 70 55 28 82 78 71 3 44 82 25 97 18 65 52 9 13 29 4 1 77 26 18 38 54 46 75 19 63 59 15 22 33 3 65 67 35 95 51 26 16 10 42 65 79 12 67 32 37 46 33 87 52
54 1 59 23 8 47 28 51 100 11 39 36 43 11 5 69 17 26 28 69 2 56 31 82 69 24 39 69 96 38 54 6 46 4 90 80 57 92 61 63 5 39 69 2 60 41 45 98 5 67 64 54 14 38 54 22 23 69 49 70 3 1 46 23 54 83 3 71 97 84 42 21 20 4 15 44 29 48 38 30 36 42 56 99 6 68 13 70 53 86 54 40 84 26 93 62
33 81 62 26 69 20 20 98 12 5 94 32 62 77 79 48 12 30 74 53 83 62 52 35 44 13 52 51 31 25 26 83 75 51 24 15 23 51 11 9 83 17 7 71 46 21 15 29 14 12 67 44 19 19 89 72 70 8 92 50 45 13 31 31 90 64 94 61 73 74 73 82 89 59 98 72 95 27 65 72 91 50 69 34 32 7 68 28 6 11 37 13 62 31 17 32
28 76 82 3 99 31 16 42 20 17 40 60 84 42 22 15 37 75 70 48 44 37 32 4 89 17 18 21 96 49 60 58 93 51 76 89 42 57 11 29 90 96 15 39 75 81 85 34 7 1 61 63 3 20 65 16 45 71 71 69 8 18 44 64 34 66 83 95 66 10 33 38 66 39 17 79 53 77 78 76 50 60 89 14 29 82 68 20 82 56 100 59 69 41 24 49
62 5 6 57 99 96 88 43 36 14 4 3 32 9 76 6 53 34 54 42 46 3 16 85 84 42 32 80 80 40 31 15 16 53 96 79 100 47 33 14 37 91 88 30 6 41 89 2 26 91 41 13 43 45 76 25 40 93 82 48 64 52 92 37 2 21 2 32 46 61 46 8 19 15 70 7 67 35 81 42 100 37 13 98 5 82 83 13 25 49 73 100 19 57 46 61
48 48 39 86 96 31 26 95 18 24 43 23 68 35 45 12 68 86 7 11 58 26 53 68 33 2 86 35 41 95 54 40 91 39 23 5 17 80 23 26 22 87 89 86 96 48 19 22 18 5 73 91 67 36 83 71 34 27 21 60 28 74 18 90 53 39 80 95 38 82 4 20 88 50 22 25 59 77 46 35 62 29 26 57 12 6 3 9 23 84 83 48 69 20 58 83
43 41 15 91 3 82 47 51 60 61 93 90 53 31 49 8 23 95 68 40 56 33 82 44 42 19 70 57 5 14 100 42 45 99 29 91 5 45 87 56 50 77 19 61 43 83 54 97 60 39 74 36 18 99 79 79 83 66 43 56 16 59 66 13 74 88 58 89 37 87 62 60 3 84 61 22 66 75 62 96 94 99 4 21 67 55 79 70 43 15 43 76 15 59 5 39
85 56 59 71 26 60 94 63 93 39 100 30 83 74 81 49 31 1 43 94 99 62 79 29 64 69 71 40 31 65 55 53 61 58 85 16 43 83 55 66 66 75 48 98 91 38 70 71 35 44 70 54 16 3 54 65 22 57 15 16 3 21 87 2 61 72 5 25 65 7 45 91 68 43 59 3 94 56 18 40 74 80 29 6 35 62 15 8 51 78 91 52 48 11 83 45
98 25 96 59 3 83 35 44 39 45 100 68 15 42 51 81 20 66 18 84 48 92 73 32 94 11 24 57 64 43 60 93 22 99 58 44 10 69 85 70 76 63 51 23 37 23 22 62 69 23 48 67 81 72 28 88 56 68 41 32 76 58 14 21 20 58 87 76 9 62 17 75 2 97 28 23 24 70 49 95 33 98 49 88 72 85 90 55 17 92 29 61 72 80 44 14
6 10 3 47 31 5 28 81 100 37 32 50 61 30 38 87 27 4 39 74 44 41 43 87 32 36 66 26 63 88 43 71 25 75 93 28 85 90 60 94 66 51 68 24 79 86 48 41 71 15 89 37 6 1 88 28 70 8 84 13 94 37 78 7 4 81 37 69 98 8 42 34 5 53 69 38 41 41 32 34 33 34 60 2 92 42 28 22 65 99 13 61 54 85 76 75
74 64 20 75 78 77 6 46 21 93 25 11 83 46 49 62 90 47 20 90 23 92 84 3 88 83 99 38 67 62 8 40 56 82 52 94 93 49 5 36 83 55 4 65 99 95 35 98 35 48 3 57 81 37 28 82 6 29 16 30 52 40 68 6 28 18 91 63 37 30 10 28 79 34 27 65 57 55 23 27 100 93 2 11 39 74 29 43 20 2 34 42 23 47 94 66
15 89 65 27 43 59 98 8 17 47 51 16 70 85 54 43 72 46 38 75 61 15 62 54 54 21 76 72 82 37 75 28 6 55 76 74 65 16 18 35 48 68 25 76 8 84 91 38 10 9 59 8 19 78 66 35 40 25 44 49 63 24 2 27 32 30 87 81 44 86 79 47 64 85 4 47 71 35 53 37 74 21 61 67 57 37 74 20 52 92 95 37 3 74 42 47
24 71 22 10 45 35 7 30 83 27 24 7 58 55 25 11 39 63 50 11 34 70 76 8 23 76 6 20 67 66 16 19 23 74 30 67 61 38 37 45 57 5 70 25 87 55 44 98 73 62 20 32 26 19 50 48 43 1 67 35 3 39 75 92 23 22 97 8 68 39 51 79 77 77 23 7 72 29 7 69 46 30 73 69 7 14 67 95 59 41 93 51 38 58 26 17
16 25 92 69 83 75 30 52 94 19 55 56 37 12 22 33 41 4 88 73 97 13 97 64 43 57 99 95 93 30 7 53 90 20 12 48 10 80 96 89 62 81 40 100 43 92 41 40 99 26 68 23 80 76 37 79 90 3 8 2 92 72 27 34 62 91 74 82 49 58 51 7 58 63 4 28 1 17 48 99 73 45 72 74 73 54 48 25 39 22 67 26 89 82 85 21
14 13 41 3 47 42 64 16 74 60 79 82 8 22 5 58 77 17 18 51 58 84 38 58 22 19 21 30 82 46 18 59 46 20 94 18 72 35 4 78 63 82 86 84 24 69 81 32 79 31 14 68 90 96 83 88 32 60 64 75 80 38 37 79 16 100 62 17 65 71 69 46 70 78 36 45 91 24 46 24 63 17 23 93 96 37 89 3 46 85 52 38 28 25 15 98
77 17 92 64 46 49 80 79 5 56 49 14 52 25 76 84 33 40 15 76 97 51 26 9 73 49 91 4 3 23 38 29 20 45 30 3 76 80 62 76 37 3 90 43 65 39 37 11 81 91 57 4 100 16 6 35 64 4 86 98 46 39 33 71 5 80 42 22 70 38 2 50 59 97 45 56 63 94 28 62 29 57 68 8 62 74 28 11 92 26 57 65 88 85 80 92
20 30 42 81 33 59 80 80 17 1 80 97 31 24 2 3 52 97 75 82 80 98 71 62 63 27 86 87 100 76 7 78 91 4 38 4 19 87 29 98 72 3 79 71 15 27 86 55 61 87 9 53 9 73 46 97 53 27 19 15 79 55 53 40 58 74 13 18 45 42 19 87 66 56 71 15 23 38 40 85 3 8 76 99 37 61 68 92 77 54 1 86 90 84 12 5
51 2 18 48 6 7 47 84 21 39 8 70 1 71 7 96 94 55 2 8 63 16 91 46 51 81 25 57 25 29 97 97 25 59 84 20 100 97 28 57 55 49 84 70 8 88 85 36 79 91 16 60 10 36 15 19 29 85 46 5 83 38 56 56 69 23 50 96 97 3 19 34 77 80 97 75 8 1 84 41 36 38 22 88 59 33 5 67 48 81 94 52 12 61 49 76
41 78 82 6 94 19 16 41 64 87 29 35 34 25 8 92 14 92 81 90 39 97 13 79 67 12 88 43 36 58 1 95 27 13 85 90 80 12 99 82 73 50 41 91 18 25 54 47 4 81 32 17 88 53 51 22 48 66 62 67 86 76 51 94 38 100 1 48 11 11 19 27 51 79 80 68 94 50 91 98 18 65 30 15 16 32 26 77 30 48 68 84 22 11 23 61
72 62 69 94 67 44 27 30 37 66 67 73 82 100 9 72 32 81 64 69 63 68 95 8 5 78 7 36 37 71 26 64 79 99 56 32 39 17 80 28 51 52 27 42 10 28 17 7 53 90 36 84 82 78 94 57 15 21 39 85 91 4 63 86 95 30 42 87 84 3 33 84 45 39 90 76 11 58 34 95 57 22 69 52 78 24 56 29 92 85 32 35 62 38 41 14
24 14 40 24 71 61 68 76 96 45 26 36 97 28 44 93 43 42 88 20 64 72 92 100 46 94 85 36 20 37 5 77 48 79 87 67 22 84 72 21 71 11 47 38 6 92 66 55 33 78 92 32 34 60 72 88 99 74 69 56 71 25 41 14 72 69 95 19 33 71 50 69 3 88 3 36 84 15 30 6 30 95 88 72 18 93 36 81 92 21 64 89 48 100 61 55
34 58 36 85 91 52 72 100 99 43 99 97 68 54 52 78 55 69 53 47 98 79 89 63 88 38 39 81 29 20 100 97 78 68 30 3 30 27 72 77 79 21 65 48 50 58 66 46 26 90 35 19 82 28 4 83 77 6 92 44 44 12 78 40 63 64 94 52 15 54 92 23 31 81 93 16 39 4 75 11 26 51 54 17 17 80 18 48 27 20 39 95 1 57 27 19
84 41 49 42 95 97 25 74 44 60 98 12 9 39 19 51 25 68 51 77 66 13 83 41 5 96 8 28 96 71 39 81 65 22 81 59 40 95 7 33 32 52 75 75 88 9 24 90 22 46 59 91 68 54 43 97 22 49 45 80 82 95 60 48 73 46 13 76 31 16 90 46 31 78 100 22 100 27 18 83 58 83 21 42 75 44 88 37 38 72 87 4 14 71 18 9
27 95 99 28 55 40 56 8 95 98 24 1 46 94 45 58 35 86 39 7 44 28 11 15 73 8 57 30 27 92 21 72 37 98 18 73 59 70 33 77 8 73 51 20 92 53 30 15 59 80 67 80 93 87 76 13 12 45 14 43 68 94 64 35 52 76 76 48 75 58 85 60 41 66 39 16 1 43 51 74 46 82 79 80 65 59 67 69 84 15 33 91 48 14 97 60
46 55 59 99 92 69 15 54 42 22 81 88 51 48 93 42 37 40 8 90 84 19 58 55 74 65 42 9 79 92 76 100 44 58 59 24 13 14 39 81 31 28 42 26 75 18 2 80 86 54 63 13 98 2 8 44 82 84 13 79 5 34 5 90 71 25 47 59 34 24 96 26 55 4 76 28 65 46 34 60 67 94 100 37 57 1 89 69 72 14 94 99 72 23 96 23
40 53 53 95 23 55 85 76 64 3 44 40 38 53 8 30 54 67 4 55 25 57 33 59 44 95 46 11 68 45 44 31 87 78 8 56 37 43 72 86 5 61 88 30 75 86 61 65 59 40 34 46 48 10 55 36 63 13 6 73 71 96 56 30 88 83 12 32 24 33 26 60 30 3 19 30 96 92 28 69 45 82 58 92 33 8 84 58 21 47 48 9 44 37 13 25
12 50 19 38 6 61 76 89 53 18 78 50 68 11 63 61 95 3 20 63 44 62 1 43 91 98 46 51 79 59 60 91 68 28 39 60 47 92 48 69 39 100 34 98 91 30 55 90 28 63 60 27 34 52 4 8 83 93 10 46 94 48 88 37 10 68 100 52 38 49 26 2 90 46 55 6 54 84 81 87 16 80 29 4 20 29 60 18 8 37 63 17 30 96 85 70
73 44 63 13 86 3 44 6 24 46 2 12 94 70 49 32 89 71 98 63 62 27 90 96 18 29 78 1 93 71 8 94 24 55 46 26 57 79 87 12 77 59 1 92 84 76 11 13 47 76 58 10 30 82 16 19 96 97 63 75 33 86 46 79 50 91 35 1 7 83 14 40 8 54 90 95 66 30 87 7 80 61 78 66 20 59 65 23 96 64 14 76 97 92 62 81
14 36 56 25 97 61 6 97 98 22 95 83 16 9 15 54 39 13 87 50 80 97 81 93 53 95 97 90 63 19 50 34 6 24 100 30 44 31 61 3 14 56 13 78 55 3 81 13 81 85 29 54 73 37 79 72 40 70 60 89 82 65 1 89 75 7 80 86 76 94 9 80 45 59 67 26 5 95 43 68 46 82 19 17 57 2 17 37 52 44 38 51 58 35 92 31
11 91 8 56 31 19 45 25 44 2 9 52 67 94 6 87 82 4 22 80 71 9 40 53 57 58 39 16 36 78 23 40 64 57 68 12 46 60 8 21 38 21 1 15 58 60 13 79 59 75 23 69 78 70 9 42 48 85 32 11 13 14 70 46 1 78 66 15 65 45 90 77 56 89 68 90 18 27 43 32 35 78 41 50 49 13 2 84 46 27 76 90 87 43 25 13
59 41 56 82 22 75 72 40 72 44 54 87 96 22 88 15 27 56 33 64 87 7 34 43 19 57 54 39 68 19 80 23 83 29 97 59 13 77 25 43 48 23 95 64 36 8 29 94 65 44 52 87 3 53 96 52 2 45 36 7 6 20 95 30 76 98 38 82 90 70 77 60 32 56 33 58 58 85 35 50 15 69 28 26 56 27 10 37 100 93 48 96 85 46 74 46
69 64 13 38 59 61 73 23 90 70 1 45 53 66 55 61 69 41 86 85 75 25 40 37 71 31 91 99 19 79 59 71 53 95 16 50 73 8 38 7 62 55 53 11 92 62 90 71 58 43 3 47 85 64 49 82 71 3 2 15 59 37 59 38 76 93 85 69 95 76 81 66 93 41 18 2 99 46 44 95 36 81 57 82 55 78 44 65 98 59 63 38 38 3 86 15
13 29 35 95 52 78 46 78 94 79 58 13 95 60 9 92 1 59 17 29 7 21 79 27 37 90 17 35 19 72 65 68 36 46 47 74 30 4 27 56 81 52 46 11 5 9 79 48 88 29 83 54 27 86 14 34 88 76 67 46 98 37 30 91 60 43 29 40 19 84 24 81 67 76 71 63 1 15 11 73 38 95 75 41 81 25 92 65 25 76 91 68 81 67 75 77
17 40 61 99 4 74 96 82 47 48 98 75 87 53 62 37 96 22 55 11 19 77 38 14 97 33 88 80 41 48 99 72 64 33 85 81 39 7 19 77 92 39 27 86 44 92 66 67 44 61 97 52 31 54 90 33 58 69 23 95 17 34 1 49 12 3 78 66 57 89 52 6 18 79 20 19 100 17 9 15 89 23 31 95 98 39 17 35 30 4 87 33 57 6 30 41
39 61 12 69 64 56 47 80 5 11 60 98 27 71 93 93 78 7 89 9 29 17 44 20 11 87 34 91 44 8 65 27 100 15 54 52 29 27 75 81 47 8 43 59 46 64 76 50 29 78 4 87 83 91 89 77 11 100 1 10 37 74 73 97 13 81 4 77 64 62 47 75 48 77 44 40 4 16 81 60 81 9 55 33 28 79 32 33 71 23 26 84 42 70 53 79
9 39 68 62 53 76 91 66 63 98 9 48 72 16 35 34 22 8 25 74 85 93 44 23 35 72 80 84 7 43 63 15 21 67 40 57 96 51 47 6 51 12 92 68 19 20 8 34 73 43 12 22 90 77 67 52 23 12 25 56 64 35 26 69 84 31 77 71 90 42 40 87 53 90 38 83 21 60 2 49 50 20 78 74 94 12 73 96 33 11 87 24 75 58 83 51
79 8 100 18 74 80 11 4 31 34 38 16 28 97 70 89 19 85 58 13 58 13 17 53 8 4 75 25 31 82 23 28 24 42 94 92 83 79 64 76 94 60 93 94 99 95 82 7 72 2 65 70 27 85 57 36 38 9 35 21 28 27 8 44 25 66 97 62 81 18 50 30 51 73 80 70 15 66 22 13 57 55 14 38 92 82 28 2 30 82 44 67 70 28 75 76
100 65 66 48 34 79 91 14 36 93 63 54 25 22 47 62 4 93 59 26 72 33 67 40 98 35 81 27 77 72 95 85 6 31 94 99 45 93 20 58 70 30 93 59 68 81 9 93 31 51 4 23 45 81 15 77 51 33 36 75 86 18 22 7 77 18 67 39 79 7 88 37 76 46 45 38 65 20 33 95 76 60 91 1 73 35 62 27 92 83 27 19 64 81 64 62
37 89 79 56 36 98 39 67 10 69 40 10 52 43 74 23 46 77 60 39 23 32 24 29 51 24 60 19 21 91 89 72 99 53 7 66 23 60 30 51 56 4 3 64 82 24 17 67 2 58 15 93 3 79 24 95 92 25 35 70 80 84 12 85 1 82 82 48 38 16 58 60 19 10 55 40 30 14 86 4 2 30 69 78 39 83 67 15 49 45 81 5 11 7 67 16
44 48 20 38 78 11 84 93 50 73 7 5 23 12 100 24 69 60 5 78 31 1 13 50 55 22 11 68 56 89 25 60 82 78 18 15 96 89 99 57 61 85 97 3 66 98 73 77 70 69 60 77 2 82 76 89 34 75 77 24 43 85 15 49 97 86 57 89 75 50 41 4 83 38 3 67 58 92 17 23 75 37 65 53 15 39 8 59 30 35 15 43 21 7 47 56
48 51 63 62 90 79 26 20 69 23 69 63 20 9 45 32 43 58 42 94 57 53 84 63 2 85 24 97 19 61 73 45 39 26 1 22 48 18 7 68 9 25 48 61 97 64 78 83 63 78 91 56 78 72 99 21 8 26 25 54 85 93 59 73 41 4 82 58 51 16 47 77 9 39 38 88 50 79 57 64 49 25 77 38 4 55 44 62 66 87 65 36 88 40 10 98
93 15 76 64 69 35 23 17 86 14 51 81 91 85 4 46 24 70 6 2 58 18 81 20 28 91 12 80 57 51 25 74 6 2 47 79 45 58 76 17 91 15 84 49 72 41 91 73 33 58 42 75 83 24 85 42 62 54 100 77 58 22 20 56 82 31 18 86 6 12 25 15 84 67 63 37 23 69 79 68 11 5 48 3 72 62 19 74 57 11 87 53 21 67 50 67
9 4 72 46 68 4 44 54 63 13 4 43 16 1 36 32 17 73 67 100 76 56 98 44 16 93 85 67 65 23 64 5 64 83 66 8 41 26 43 36 92 63 1 2 47 57 19 14 52 84 46 89 27 95 84 27 53 46 32 84 80 94 68 49 59 49 62 12 100 44 62 31 39 15 2 93 16 80 92 24 62 74 27 73 87 19 39 4 22 84 3 31 79 91 73 97
49 57 83 31 61 40 13 57 26 56 95 26 21 24 47 3 73 46 92 22 87 69 84 53 89 32 6 34 86 29 96 89 10 99 30 3 14 11 78 11 71 50 29 39 34 11 89 64 71 81 32 92 12 77 58 32 87 85 22 43 98 80 31 94 38 60 42 19 8 87 71 46 6 7 83 48 61 34 49 26 58 13 57 75 71 55 47 29 98 68 11 52 78 5 3 45
97 94 8 54 99 89 32 67 84 47 67 8 48 50 18 34 86 29 73 88 65 88 62 65 80 74 80 90 33 88 63 5 26 44 42 68 45 28 64 2 48 92 56 51 87 40 20 55 61 7 93 74 42 16 47 48 35 78 54 25 87 98 3 64 50 34 85 7 95 46 92 15 48 10 25 42 92 33 1 75 55 38 84 62 86 97 79 78 7 39 42 35 82 68 77 34
32 95 4 23 92 35 32 25 65 11 71 72 15 97 18 36 38 46 69 21 66 7 44 21 77 32 36 76 12 87 4 77 57 11 48 100 28 67 97 8 93 71 10 50 42 3 70 72 30 46 97 78 44 54 66 79 8 29 95 67 3 12 60 77 91 76 53 82 33 11 29 24 80 36 87 99 74 28 35 46 7 69 19 93 63 49 87 98 37 22 24 54 94 7 38 90
65
37
45
39
45
70
69
55
6
3
72
78
54
1
26
68
47
10
31
24
