5 5
1 1 1 1 1
1 -2 2 -2 1
1 2 3 2 1
1 -2 2 -2 1
1 1 1 1 1
1
2
3
4
5
6
