10 10
6 2 0 -6 -2 4 -1 8 5 7 
4 -8 6 -8 6 10 10 -5 -6 -3 
-10 7 7 -10 9 -5 2 -7 7 10 
2 4 8 2 -10 7 0 7 -10 8 
9 5 1 -10 6 1 5 2 -4 -9 
1 -3 -4 10 -5 10 8 -2 9 1 
-8 0 0 -8 -5 -3 0 -4 0 7 
-9 4 -4 3 9 4 -10 -9 -4 -8 
7 -10 -6 5 -5 -10 1 -4 10 10 
1 -5 1 9 -4 -5 -1 8 -3 -8 
1
7
9
4
10
8
1
6
1
2
5
9
2
3
5
9
3
3
9
10
6
8
10
9
8
7
4
9
6
9
2
10
6
9
8
1
1
8
1
3
7
7
2
6
6
1
7
3
10
8
