10 10
5 0 -3 -9 -2 10 -6 -9 10 -5 
6 3 -3 4 5 1 -1 6 -4 -7 
-9 -1 5 -5 -8 10 -1 -10 -3 8 
7 1 2 -3 -3 -4 1 3 -3 8 
8 9 7 6 4 -7 -5 -8 -10 7 
-7 1 -6 -6 2 6 4 7 9 9 
-10 0 10 -2 8 -10 9 4 6 -1 
1 -9 -7 5 -5 1 -4 2 0 -1 
-5 6 2 7 5 3 0 -7 5 10 
6 10 10 10 1 6 0 -6 -8 8 
3
10
10
4
10
9
8
4
4
8
5
1
5
1
8
5
8
4
2
10
3
3
5
6
2
10
6
7
3
8
9
4
6
5
5
4
7
10
9
8
5
4
1
8
7
1
3
6
7
4
4
2
10
8
5
5
9
6
4
4
2
1
7
7
6
6
1
1
3
3
9
8
3
3
1
7
8
5
8
6
2
5
4
7
2
10
4
8
6
2
5
10
10
2
1
2
10
7
4
10
