10 10
7 -10 0 -1 2 -2 -3 10 3 6 
4 -10 -8 -6 9 -4 -4 -5 -2 1 
10 -6 -2 -8 5 -4 2 6 10 4 
-7 1 0 10 -1 -8 1 5 -7 -3 
-8 -7 7 -7 10 -8 -4 -7 8 7 
-3 -3 6 -6 -4 10 -2 7 10 -10 
4 10 -7 7 10 6 10 10 -3 -7 
3 8 7 5 -3 0 7 5 1 1 
9 2 -2 -6 3 7 9 -6 4 -7 
-1 -6 -9 0 -8 -3 -4 -10 4 9 
5
4
3
3
10
3
8
7
10
7
2
2
10
5
3
5
5
8
10
7
8
2
1
2
4
6
9
6
2
5
4
4
5
4
6
3
1
8
6
3
6
1
8
4
7
3
10
5
2
9
7
1
9
7
6
5
3
3
7
8
7
4
1
4
8
9
4
5
10
6
5
7
6
1
5
1
5
3
5
8
8
4
7
4
3
5
10
1
9
5
3
7
5
2
1
3
1
4
2
10
