10 10
-10 -5 -7 -4 -10 3 -8 -6 3 1 
-9 1 -10 5 0 7 -4 -5 1 1 
-1 4 2 2 3 0 9 3 8 6 
5 0 4 -3 8 -3 4 1 -7 1 
6 -10 -6 -10 8 1 -6 -10 10 3 
-3 6 -4 8 1 2 -5 -1 5 1 
3 -6 6 5 -4 -1 -9 7 -2 3 
6 -6 -1 -5 -5 -9 -10 -8 4 10 
-10 -3 9 -4 -7 9 -6 6 -7 -6 
-10 8 8 -9 10 -6 -2 0 9 9 
9
7
2
5
2
2
8
3
3
1
10
3
6
8
5
6
3
10
1
6
4
7
9
5
2
3
5
1
2
4
10
9
4
9
3
8
4
6
6
5
3
4
3
2
2
1
8
5
10
9
1
4
9
10
7
3
5
9
9
2
2
4
9
10
9
5
3
3
3
7
8
7
3
10
5
5
9
4
9
7
3
7
3
8
1
9
2
1
3
9
4
10
3
9
3
9
10
1
4
1
