20 20
6 -7 -7 0 -1 -6 10 -4 0 -8 -8 9 5 -3 -1 -4 9 0 2 10 
5 4 0 -5 8 10 -7 -9 1 -8 4 1 -7 5 6 -2 0 -4 -3 -8 
-9 1 2 -6 -8 -2 4 9 3 5 9 -4 4 -4 -9 8 5 -2 -10 1 
10 -10 1 -10 2 -10 -8 10 7 -6 2 -6 -9 9 6 -6 1 -8 -5 -1 
5 6 -7 3 -2 5 -8 2 8 2 -7 3 -6 -4 6 -2 1 -6 7 4 
10 -7 -4 -10 6 1 -1 6 4 4 8 8 -5 6 2 3 5 -1 10 3 
5 -4 8 -10 10 -2 -5 5 -9 -2 -1 0 6 -5 -6 -3 9 -9 9 -6 
-6 10 -7 2 3 4 1 3 -8 -8 1 9 3 -7 3 5 6 -4 1 -8 
-1 4 0 10 0 -10 0 -3 -7 -6 10 7 0 10 -2 -6 5 6 -10 10 
-8 -8 0 0 0 7 1 -3 -3 6 2 -1 -4 -8 2 1 8 -7 3 -7 
-9 3 -6 -1 -8 -7 10 1 -2 0 7 1 6 -1 4 -3 8 -10 2 -8 
-3 1 1 7 3 10 -1 7 -7 1 -8 10 10 -3 3 -9 -7 -2 3 10 
7 6 -5 -7 10 -6 4 -7 -5 -2 1 -1 10 -2 4 -9 5 -1 6 -5 
-5 0 -2 -7 5 9 0 -3 9 6 -10 2 9 4 -2 9 -10 -5 7 -1 
8 4 -8 3 6 0 -3 -5 -5 -3 8 -2 -8 0 -1 -3 4 -6 2 0 
9 3 0 -9 10 -5 -8 5 6 2 -1 -5 8 4 3 -5 -9 5 -4 -7 
9 -4 2 -4 -5 1 -1 -5 -5 10 6 -3 -1 5 0 7 5 -3 -5 -4 
-3 -3 -5 5 7 -1 6 -1 -5 3 0 -4 9 6 7 -4 5 -4 2 4 
3 7 -1 6 2 -4 -5 -1 8 3 -3 -9 9 2 2 1 -7 -1 1 8 
-5 6 -3 8 -3 -5 6 -4 3 -9 6 -3 1 -5 4 -10 5 -4 -4 0 
4
13
17
19
8
3
1
11
15
18
1
11
17
9
18
5
8
13
19
8
